          0           1                0
          x          -3                0
          x          -1                0
          x          -1      -4303216330
          x          -1   -1385426608210
          x          -1  -28151600271490
          x          -1 -133356294869770
          x          -1 -246049104302782
          x          -1 -279357902406934
          x          -1 -281464624022902
          x          -1 -281474976710670
          x          -1 -281474976710656
          0          -1 -281474976710656
